2 2 2 2 2 2 2 2 2 2 2 2 2 2 2 2 2 2 2 2 2 2 2 2 2 2 2 2 2 2 2 2 2 2 2 2 2 2 2 2 2 2 2 2 2 2 2 2 2 2
2 2 2 2 2 2 3 3 3 3 3 3 3 3 3 3 2 2 4 4 4 4 4 4 4 4 4 4 4 4 4 5 5 5 5 5 5 2 3 3 3 3 3 3 3 3 3 3 3 3
2 2 2 3 3 3 3 4 4 4 4 4 4 4 4 3 2 2 4 3 3 3 4 3 3 3 4 3 3 3 4 5 5 5 5 5 5 2 3 3 3 3 3 3 3 3 3 3 3 3
2 2 2 3 4 4 4 4 4 4 4 4 4 4 4 3 2 2 2 4 4 4 4 4 4 4 4 4 4 4 4 5 5 5 5 5 2 2 3 0 0 0 0 0 0 0 0 0 0 0
2 2 5 3 4 4 4 4 4 4 3 3 3 4 4 3 2 2 2 4 4 4 4 4 4 4 4 4 4 4 4 5 5 5 5 5 2 2 3 1 5 5 5 5 5 5 5 5 5 5
2 2 5 3 4 4 4 4 4 4 3 5 3 4 4 3 2 2 4 4 4 4 4 4 4 4 4 4 4 4 4 5 5 5 5 5 2 2 3 1 5 5 5 5 5 5 5 5 5 5
2 2 5 3 4 4 4 4 4 4 3 5 3 4 4 3 2 2 4 4 4 4 4 4 4 4 4 4 4 4 4 5 5 5 5 5 2 2 3 1 5 5 5 5 5 5 5 5 5 5
2 2 5 3 3 3 4 3 3 3 3 5 3 3 3 3 2 2 4 4 4 4 4 4 4 4 4 4 4 4 5 5 5 5 5 5 2 2 3 1 5 5 5 5 5 5 5 5 5 5
2 2 5 5 5 5 1 5 5 5 5 5 5 5 5 5 4 4 4 4 4 4 4 4 4 4 4 4 4 4 4 5 5 5 5 5 2 2 3 1 5 5 5 5 5 5 5 5 5 5
2 2 5 5 5 5 1 5 5 5 5 5 5 5 5 5 4 4 4 4 4 4 4 4 4 4 4 4 4 4 4 5 5 5 5 5 2 2 3 1 5 5 5 5 5 5 5 5 5 5
2 2 5 5 5 5 1 5 5 5 5 5 5 5 5 5 5 4 4 4 4 4 4 4 4 4 4 4 4 4 4 5 5 5 5 5 2 2 3 1 3 3 3 3 3 5 5 5 5 5
2 2 5 5 5 5 1 5 5 5 5 5 5 5 5 5 5 5 4 4 4 4 4 4 4 4 4 4 4 4 5 5 5 5 5 5 2 2 3 1 4 3 3 3 4 5 5 5 5 5
2 2 5 5 5 5 1 5 5 5 5 5 5 5 5 5 5 5 4 4 4 4 4 4 4 4 4 4 4 4 5 5 5 5 5 5 2 2 3 1 3 3 3 3 3 5 5 5 5 5
2 2 5 5 5 5 1 5 5 5 5 5 5 5 5 5 5 5 5 5 5 5 5 5 5 5 5 5 5 5 5 5 5 5 5 5 2 2 2 1 0 0 0 0 0 0 0 0 0 0
2 5 5 2 2 5 1 3 3 3 3 3 5 5 5 5 5 5 5 5 5 5 5 5 5 5 5 5 5 5 5 5 5 5 5 5 5 2 2 1 3 3 3 3 3 3 3 3 3 3
2 2 2 2 2 5 1 3 4 4 4 3 5 3 3 3 3 3 3 5 5 5 5 5 5 5 5 5 5 5 5 5 5 5 5 5 5 2 2 1 3 4 4 4 4 4 4 4 4 4
2 2 2 2 2 2 1 3 4 4 4 3 5 3 4 4 4 4 3 5 5 5 5 5 5 5 5 5 5 5 5 5 5 5 5 5 5 2 2 1 3 4 4 4 4 4 4 4 4 4
2 2 2 2 2 2 1 3 4 4 4 3 5 3 4 4 4 4 3 5 5 5 5 5 5 5 5 5 5 5 5 5 5 5 5 5 5 2 2 1 3 4 4 4 4 4 4 4 4 4
2 2 2 2 2 2 1 3 3 4 3 3 5 3 3 4 3 3 3 5 5 5 5 5 5 5 5 5 5 5 5 5 5 5 5 5 5 2 2 1 3 3 3 3 3 4 3 3 3 3
2 2 2 2 2 2 0 0 0 0 0 0 0 0 0 0 9 0 0 0 0 0 0 0 0 0 0 0 9 0 0 0 0 0 0 9 0 0 0 0 0 0 0 0 0 0 0 0 0 0
2 2 2 2 2 2 1 5 5 5 5 5 5 5 5 5 1 5 5 5 5 3 3 4 3 3 3 3 1 5 5 5 5 5 5 1 5 5 5 5 5 5 4 4 4 4 4 4 4 4
2 2 2 2 2 2 1 5 5 5 5 5 5 5 5 5 1 5 5 5 5 3 4 4 4 4 4 3 1 5 5 5 5 5 5 1 5 5 5 5 5 5 4 4 4 4 4 4 4 4
2 2 2 2 2 2 1 5 5 5 5 5 5 5 5 5 1 5 5 5 5 3 4 4 4 4 4 3 1 5 5 5 5 5 5 1 5 5 5 5 5 4 4 4 4 4 4 4 4 4
2 2 2 2 2 2 1 5 5 5 5 5 5 5 5 5 1 5 5 5 5 3 4 4 4 4 4 3 1 5 5 5 5 5 5 1 5 5 5 5 5 4 4 4 4 4 4 4 4 4
2 4 2 2 2 2 1 5 5 5 5 5 5 5 5 5 1 5 5 5 5 3 3 3 3 3 3 3 1 5 5 5 5 5 5 1 5 5 5 5 5 4 4 4 4 4 4 4 4 4
2 4 4 2 2 2 1 5 5 5 5 5 5 3 3 3 1 3 3 3 5 5 5 5 5 5 5 5 1 5 5 5 5 5 5 1 5 5 5 5 5 4 4 4 4 4 4 4 4 4
2 4 4 2 2 4 1 5 5 5 5 5 5 3 3 4 1 3 3 3 5 5 5 5 5 5 5 5 1 5 5 5 5 5 5 1 5 5 5 5 5 5 5 4 4 4 4 4 4 4
2 4 4 2 2 4 1 5 5 5 5 5 5 3 3 3 0 3 4 3 5 5 5 5 5 5 5 5 1 5 5 5 5 5 5 1 5 5 5 5 5 5 5 4 4 4 4 4 4 4
2 4 4 4 4 4 1 5 5 5 5 5 5 5 5 5 0 0 0 0 0 0 0 0 0 0 0 0 0 0 0 0 0 0 0 1 5 5 5 5 5 5 5 4 4 4 4 4 4 4
2 4 4 4 3 4 1 5 5 5 5 5 5 5 5 5 5 5 3 4 3 1 5 5 5 5 5 5 1 5 5 5 5 5 5 1 5 5 5 5 5 5 4 4 4 4 4 4 4 4
2 5 0 0 0 0 1 5 5 5 5 5 5 5 5 5 5 5 3 3 3 1 5 5 5 5 5 5 1 5 5 5 5 5 5 1 5 5 5 5 5 5 4 4 4 4 4 4 4 4
2 5 1 5 5 5 5 5 5 5 5 5 5 5 5 5 5 5 5 5 5 1 5 5 5 5 5 5 1 5 5 5 5 5 5 1 5 5 5 5 5 5 4 4 4 4 4 4 4 4
2 5 1 5 5 5 5 5 5 5 5 5 5 5 5 5 5 5 3 3 3 1 5 5 5 5 5 5 1 5 5 5 5 5 5 1 5 5 5 5 5 5 4 4 4 4 4 4 4 4
2 5 1 3 3 5 5 5 5 5 5 5 5 5 5 5 5 5 3 3 4 1 5 5 5 5 5 5 1 5 5 5 5 5 5 1 5 5 5 5 5 5 4 4 4 4 4 4 4 5
2 5 1 3 3 5 5 5 5 5 5 5 5 5 5 5 5 5 3 3 4 1 5 5 5 5 5 5 1 5 5 5 5 5 5 1 5 5 5 5 5 5 5 4 4 4 4 5 5 5
2 5 1 3 3 5 5 5 5 5 5 5 5 5 5 5 5 5 3 3 3 1 5 5 5 5 5 5 1 5 5 5 5 5 5 1 5 5 5 5 5 5 5 5 4 4 4 5 5 5
2 5 1 5 5 5 5 5 5 5 5 5 5 5 5 5 5 5 3 3 3 1 5 5 5 5 5 5 1 5 5 5 5 5 5 1 5 5 5 5 5 5 5 5 4 4 4 0 0 0
2 5 1 5 5 5 5 5 5 5 5 0 0 0 0 0 0 0 0 0 0 0 0 0 0 0 0 0 1 0 0 0 0 0 0 0 5 5 5 5 5 5 5 5 4 4 4 5 5 5
2 5 1 5 5 5 5 5 5 5 5 5 5 5 5 5 5 5 3 4 3 5 5 5 5 5 5 5 1 5 5 5 5 5 5 5 5 5 5 5 5 5 5 5 4 4 4 4 4 5
2 5 1 5 5 5 5 5 5 5 5 5 5 5 5 5 5 5 3 3 3 5 5 5 5 5 5 5 1 5 5 5 5 5 5 5 5 5 5 5 5 5 5 5 4 4 4 4 4 5
2 5 1 5 5 5 5 5 5 5 5 5 5 5 5 5 5 5 5 5 5 5 5 5 5 5 5 5 1 5 5 5 5 5 5 5 5 5 5 5 5 5 5 5 4 4 4 4 5 5
2 5 1 5 5 5 5 5 5 5 5 5 5 5 5 5 5 5 5 5 3 3 3 5 5 5 5 5 1 5 5 5 5 5 5 5 5 5 5 5 5 5 5 5 4 3 4 5 5 5
2 5 1 5 5 5 5 5 5 5 5 5 5 5 5 5 5 5 3 3 3 3 3 3 3 5 5 5 1 5 5 5 5 5 5 5 5 5 5 5 5 5 5 5 4 4 4 5 5 5
2 5 1 0 0 0 0 0 0 0 0 0 0 0 0 0 0 0 0 0 0 0 0 0 0 0 0 0 1 5 5 5 5 5 5 5 5 5 5 5 5 5 5 5 5 5 5 5 5 5
2 5 5 5 5 5 5 5 5 5 5 5 5 5 5 5 5 5 5 5 5 5 5 5 5 5 5 5 5 5 5 5 5 5 5 5 5 5 5 5 5 5 5 5 5 5 5 5 5 5
2 5 5 5 5 5 5 5 5 5 5 5 5 5 5 5 5 5 5 5 5 5 5 5 5 5 5 5 5 5 5 5 5 5 5 5 5 5 5 5 5 5 5 5 5 5 5 5 5 5
2 2 2 2 2 2 2 2 2 2 2 2 2 2 2 2 2 2 2 2 2 2 2 2 2 2 2 2 2 2 2 2 2 2 2 2 2 2 2 2 2 2 2 2 2 2 2 2 2 2
2 2 2 2 2 2 2 2 2 2 2 2 2 2 2 2 2 2 2 2 2 2 2 2 2 2 2 2 2 2 2 2 2 2 2 2 2 2 2 2 2 2 2 2 2 2 2 2 2 2
2 2 2 2 2 2 2 2 2 2 2 2 2 2 2 2 2 2 2 2 2 2 2 2 2 2 2 2 2 2 2 2 2 2 2 2 2 2 2 2 2 2 2 2 2 2 2 2 2 2
2 2 2 2 2 2 2 2 2 2 2 2 2 2 2 2 2 2 2 2 2 2 2 2 2 2 2 2 2 2 2 2 2 2 2 2 2 2 2 2 2 2 2 2 2 2 2 2 2 2