12 12 12 12 12 12 12 12 12 12 12 12 12 12 12 12 12 12 12 12 12 12 12 12 12 12 12 12 12 12 12 12 12 12 12 12 12 12 12 12 12 12 12 12 12 12 12 12 12 12
12 12 12 12 12 12 13 13 13 13 13 13 13 13 13 13 12 12 12 12 12 12 12 12 12 12 12 14 14 14 14 15 15 15 12 12 12 12 12 12 12 12 12 12 12 12 12 12 12 12
12 12 12 13 13 13 13 14 14 14 14 14 14 14 14 13 12 12 12 12 12 12 12 12 12 12 14 13 13 13 14 15 15 15 12 12 12 12 12 12 12 12 12 12 12 12 12 12 12 12
12 12 12 13 14 14 14 14 14 14 14 14 14 14 14 13 12 12 26 14 14 12 26 14 14 14 14 14 14 14 14 15 15 15 12 12 12 12 26 14 14 14 14 12 12 12 12 12 12 12
12 12 15 13 14 14 14 14 14 14 13 13 13 14 14 13 12 12 26 14 14 12 26 14 14 14 14 14 14 14 14 15 15 15 12 12 12 12 26 14 14 14 14 14 12 12 12 12 12 12
12 12 15 13 14 14 14 14 14 14 13 15 13 14 14 13 12 26 14 14 14 12 26 14 14 14 14 14 14 14 14 15 15 15 12 12 12 12 26 14 14 14 14 14 12 12 12 12 12 12
12 12 15 13 14 14 14 14 14 14 13 15 13 14 14 13 12 26 14 14 14 12 26 14 14 14 14 14 14 14 14 15 15 12 12 12 12 12 26 14 14 14 14 14 12 12 12 12 12 12
12 12 15 13 13 13 14 13 13 13 13 15 13 13 13 13 12 26 14 14 14 12 26 14 14 14 14 14 14 14 15 15 15 15 12 12 12 12 26 14 14 14 14 14 12 12 12 12 12 12
12 12 15 15 15 15 11 15 15 15 15 15 15 12 12 26 14 14 14 12 12 12 26 14 14 14 14 14 14 14 14 15 15 15 12 12 12 12 26 14 14 14 14 14 12 12 12 12 12 12
12 12 15 15 15 15 11 15 15 15 15 15 15 12 12 26 14 14 14 12 12 12 26 14 14 14 14 14 14 14 14 12 12 12 12 12 12 12 26 14 14 14 14 14 14 12 12 12 12 12
12 12 15 15 15 15 11 15 15 15 15 15 15 12 12 12 15 14 14 12 12 12 26 14 14 14 14 14 14 14 12 12 12 12 12 12 12 12 12 11 13 13 13 13 13 12 12 12 12 12
12 12 15 15 15 15 11 15 15 15 15 15 15 12 12 12 12 12 14 14 12 12 12 14 14 14 14 14 14 14 15 15 12 12 12 12 12 12 12 11 13 13 13 13 13 12 12 12 12 12
12 12 15 16 15 15 11 15 15 15 15 15 15 12 12 12 12 12 14 14 12 12 26 14 14 14 14 14 14 14 15 15 15 12 12 12 12 12 12 11 13 13 14 13 13 12 12 12 12 12
12 12 15 15 15 15 11 15 15 15 15 15 15 12 12 12 12 12 12 12 12 12 12 15 15 15 15 15 15 15 15 15 15 12 12 12 12 12 12 20 10 10 22 12 12 12 12 12 12 12
12 15 15 12 12 15 11 13 13 13 13 13 15 12 12 12 12 12 12 12 12 12 12 15 15 15 15 15 15 15 16 15 15 12 12 12 12 12 12 11 13 13 13 13 13 13 13 13 13 13
12 12 12 12 12 15 11 13 14 14 14 13 15 15 15 12 12 12 12 12 12 12 12 15 15 15 15 15 15 15 15 15 15 15 12 12 12 12 12 11 13 14 14 14 14 14 14 14 14 13
12 12 12 12 12 12 11 13 14 14 14 13 15 16 15 12 12 12 12 12 12 12 12 12 15 15 15 15 16 15 15 15 15 15 15 15 12 12 12 11 13 14 14 14 14 14 14 14 14 13
12 12 12 12 12 12 11 13 14 14 14 13 15 15 15 12 12 12 12 12 12 12 12 12 12 15 15 15 15 15 15 15 15 15 15 15 12 12 12 11 13 14 14 14 14 14 14 14 14 13
12 12 12 12 12 12 11 13 13 14 13 13 15 15 15 12 12 12 12 12 12 12 12 12 12 12 12 12 15 15 15 15 15 15 15 12 12 12 12 11 13 13 13 13 13 14 13 13 13 13
12 12 12 12 12 12 20 10 10 10 15 15 15 15 15 12 12 12 12 12 12 12 12 12 12 12 12 12 25 10 10 10 10 10 10 10 10 10 10 18 10 10 10 10 10 10 10 10 10 13
12 12 12 12 12 12 11 12 12 12 15 15 15 15 15 12 12 12 12 12 12 12 29 29 29 29 12 12 11 15 15 15 15 15 15 12 12 12 12 12 12 26 14 14 14 14 14 14 14 27
12 12 12 12 12 12 11 12 12 12 15 15 15 15 15 12 12 12 12 12 12 26 14 14 14 14 27 12 11 15 15 15 15 15 15 12 12 12 12 12 12 26 14 14 14 14 14 14 14 27
12 12 12 12 12 12 11 12 12 12 15 16 15 15 15 12 12 12 12 12 12 26 14 14 14 14 27 12 11 15 15 15 15 15 15 12 12 12 12 12 26 14 14 14 14 14 14 14 14 27
12 12 12 12 12 12 11 12 12 12 15 15 15 15 15 12 12 12 12 12 12 26 14 14 14 14 27 12 11 15 15 16 15 15 12 12 12 12 12 12 26 14 14 14 14 14 14 14 14 27
26 14 12 12 12 12 11 12 12 12 15 15 15 15 15 12 12 12 12 12 12 12 28 26 14 27 12 12 11 15 15 15 15 15 12 12 12 12 12 12 26 14 14 14 14 14 14 14 14 27
26 14 14 12 12 12 11 12 12 12 15 15 15 13 13 12 12 12 12 12 12 12 12 12 11 12 12 12 11 15 15 15 15 15 12 12 12 12 12 12 26 14 14 14 14 14 14 14 14 27
26 14 14 12 26 14 11 12 12 12 15 15 15 13 13 12 12 12 12 12 12 12 12 12 23 10 10 10 22 15 15 15 15 15 12 12 12 12 12 12 26 15 15 14 14 14 14 14 14 27
26 14 14 12 26 14 11 12 12 12 15 15 15 13 13 12 12 12 12 12 12 12 15 15 15 15 15 15 15 15 16 15 15 12 12 12 12 12 12 12 26 15 15 14 14 14 14 14 14 27
26 14 14 14 14 14 11 12 12 12 15 15 15 15 15 12 12 12 12 12 12 12 15 15 15 15 15 15 15 15 15 15 12 12 12 12 12 12 12 12 12 26 15 14 14 14 14 14 14 27
26 14 14 14 13 14 11 12 12 12 15 15 15 15 15 15 15 12 12 12 12 12 15 15 16 15 15 15 15 15 15 15 12 12 12 12 12 12 12 12 12 26 14 14 14 14 14 14 14 27
12 15 25 10 10 10 22 12 12 12 15 15 15 15 15 15 15 12 12 12 12 12 15 15 15 15 15 15 15 15 15 12 12 12 12 12 12 12 12 12 12 26 14 14 14 14 14 14 14 27
12 15 11 15 15 15 12 12 12 12 15 15 15 15 15 15 15 12 12 12 12 12 15 15 15 15 15 15 15 15 15 12 12 12 12 12 12 12 12 12 12 26 14 14 14 14 14 14 14 27
12 15 11 15 16 15 12 12 12 12 15 15 16 15 15 15 15 12 12 12 12 12 15 16 15 15 15 15 16 15 15 12 12 12 12 12 12 13 13 13 13 13 13 13 14 14 14 14 14 27
12 15 11 13 13 15 12 12 12 12 15 15 15 15 15 15 15 12 12 12 12 12 15 15 15 15 15 15 15 15 15 12 12 12 12 12 12 13 14 14 14 14 14 13 14 14 14 14 14 27
12 16 11 13 13 15 12 12 12 12 15 15 15 15 15 15 15 12 12 12 12 12 12 12 12 12 12 12 12 12 12 12 12 12 12 12 12 13 14 14 14 14 14 13 14 14 14 14 14 27
12 15 11 13 13 15 12 12 12 12 15 15 15 15 15 15 15 12 12 12 12 12 12 12 12 12 12 12 12 12 12 12 12 12 12 12 12 13 14 14 14 14 14 13 14 14 14 14 14 27
12 15 11 15 15 12 12 12 12 12 15 15 15 15 15 15 15 12 12 12 12 12 12 12 12 12 12 12 12 12 12 12 12 12 12 12 12 13 14 14 14 14 14 13 14 14 14 14 14 27
12 15 11 15 12 12 12 12 12 15 15 10 10 10 10 10 10 24 12 12 12 12 12 12 12 12 12 12 12 12 12 12 12 12 12 12 12 13 14 13 13 13 14 13 14 14 14 14 14 27
12 15 11 12 12 12 12 12 12 12 15 15 15 15 15 15 15 11 14 14 14 14 14 14 14 14 14 14 14 14 14 14 14 14 14 14 12 12 11 12 12 13 14 13 14 14 14 14 14 27
12 15 11 12 12 12 12 12 12 12 15 15 15 15 15 15 15 23 10 10 10 10 10 10 10 10 10 10 17 10 10 10 10 10 10 10 10 10 22 12 12 12 11 12 14 14 14 14 14 27
12 15 11 12 12 12 12 12 12 12 15 15 15 15 15 15 15 15 15 15 15 15 15 15 15 15 15 15 11 15 15 15 15 15 15 15 15 15 12 12 12 12 11 12 14 14 14 14 14 27
12 15 11 12 12 12 12 12 12 12 15 15 15 15 15 15 15 15 15 15 13 13 13 15 15 15 15 15 11 12 12 12 12 12 12 12 12 12 12 12 12 12 23 10 14 14 14 14 14 27
12 15 11 12 12 12 12 12 12 12 12 12 12 12 12 12 12 12 12 12 12 12 12 12 12 12 12 12 11 12 12 12 12 12 12 12 12 12 12 12 12 12 15 14 14 14 14 14 15 12
12 15 23 10 10 10 10 10 10 10 10 10 10 10 10 10 10 10 10 10 10 10 10 10 10 10 10 10 22 12 12 12 15 15 12 12 12 12 12 12 12 12 15 15 15 15 15 27 12 12
12 15 15 15 15 15 15 15 15 15 15 15 15 15 15 15 15 15 15 15 15 15 15 15 15 15 15 15 15 12 12 12 16 15 15 12 12 12 12 12 12 12 12 12 15 15 12 12 12 12
12 15 15 15 15 15 15 15 15 15 15 15 15 15 15 15 15 15 15 16 15 15 15 15 15 15 15 15 15 15 15 15 15 15 12 12 15 12 12 12 12 12 12 12 12 12 12 12 12 12
12 12 12 12 12 12 12 12 12 12 12 12 12 12 12 12 12 12 12 12 12 12 12 12 12 12 12 12 12 12 12 12 12 12 12 12 12 12 12 12 12 12 12 12 12 12 12 12 12 12
12 12 12 12 12 12 12 12 12 12 12 12 12 12 12 12 12 12 12 12 12 12 12 12 12 12 12 12 12 12 12 12 12 12 12 12 12 12 12 12 12 12 12 12 12 12 12 12 12 12
12 12 12 12 12 12 12 12 12 12 12 12 12 12 12 12 12 12 12 12 12 12 12 12 12 12 12 12 12 12 12 12 12 12 12 12 12 12 12 12 12 12 12 12 12 12 12 12 12 12
12 12 12 12 12 12 12 12 12 12 12 12 12 12 12 12 12 12 12 12 12 12 12 12 12 12 12 12 12 12 12 12 12 12 12 12 12 12 12 12 12 12 12 12 12 12 12 12 12 12